idol - oshi no ko
work - hell's paradise
souvenir - spy x family
river - vinland saga
unravel - tokyo ghoul
this game - no game no life
clattanoia - overlord
gurenge - demon slayer
kibou no uta - food wars
kick back - chainsaw man
guren no yumiya - attack on titan
fiction - wotakoi
hikaru nara - your lie in april
cry baby - tokyo revengers
kawaki wo ameku - domestic girlfriend
dream lantern - your name
3-bun 29-byo - 86
kaikai kitan - jujutsu kaisen
inferno - fire force
a cruel angel's thesis - neon genesis evangelion
sincerely - violet evergarden
good morning world! - dr. stone
rise - the rising of the shield hero
tomorrow - konosuba
ambiguous - kill la kill
daddy! daddy! do! - kaguya-sama: love is war
bloody stream - jojo's bizarre adventure
99 - mob psycho 100
kyouran hey kids! - noragami
irokousui - horimiya
kimi ga yume wo tsuretekita - the pet girl of sakurasou
tabibito no uta - mushoku tensei: jobless reincarnation
crossing field - sword art online
suzume - suzume
colors - code geass
redo - re:zero
seishun complex - bocchi the rock
bibitto love - science fell in love, so i tried to prove it
takt - takt op. destiny
alive - lycoris recoil
anima - sword art online
the hero !! - one punch man
kizuna no kiseki - demon slayer
rumbling - attack on titan
giri giri - kaguya-sama: love is war
daten - call of the night
blue bird - naruto shippuden
enemy - arcane
jiyuu no tsubasa - attack on titan
mixed nuts - spy x family
grand blue - grand blue
sekaiwa koi ni ochiteiru - blue spring ride
honey jet coaster - shikimori's not just a cutie
sh0ut - re:creators
mukanjyo - vinland saga
cantabile - blue orchestra
judgement - blue lock
knock out - mashle
highest - the eminence in shadow
shall we dance? - shadows house
shinda - the legendary hero is dead!
kurae! telepathy - tomo-chan is a girl!
kaibutsu - beastars
mephisto - oshi no ko
the world - death note
1 - mob psycho 100
innocent arrogance - heavenly delusion
harumodoki - oregairu
caste room - classroom of the elite
hacking to the gate - steins;gate
ganbare! kumoko-san - so i'm a spider, so what?
chitty chitty bang bang - ya boy kongming!
koi no uta - tonikawa: over the moon for you
seishun satsubatsu-ron - assassination classroom
again - fullmetal alchemist: brotherhood
odd future - my hero academia
grand escape - weathering with you